1 13 31
###############################
#p bfls       * * *    ***    #
# #*# #*#*# # # #*# #*#*#*# #*#
#**s*               *f*      *#
# # # #*# #*#*#*#*#*# # #*#f#*#
#   **     ***   *l*     *** 5#
#*# # # #*#*#*# #*#*# # #*#*#*#
#f*           * *   *  *    **#
#*# # # #*# # # #*# # #*# # # #
#  x    ***     *** *         #
# #*# # #*# # # #*# # # #*#*# #
# ***   ***   *6*        * *  #
###############################

###############################
#p b*   1                    1#
# #*#s#*#*#*#*#*#*#*#*#*#*#*#*#
#**   * * * *1*   *   * 2 * **#
# # # # # # # # # # # # # # #*#
# *   *   * * * l * * *1  f5**#
# # #*# # # # # # # # #*# # #x#
#f* *** * *   *   * * *   *   #
#*#*#*#*#*#*#*#*#*#*#*#*#*#*#*#
#  *   *   *   *   *   * 2 * *#
# # # # # # # # # # # # # # # #
#*   *   *   * 6 *   *   *   *#
###############################

###############################
#p b*  *** ** *   2     ** * *#
# #*#*#*# # # #*# #*# # # #*#*#
# *s*   *****      1  ** * *  #
#*#f#*# # #*# # # # # #*#*# # #
#  f**    *** ** * * 2 ***   5#
# #*#*# # # # # #*#l#*#*# # # #
#* ** 1       *** * * * *     #
#*#*# # # #*#*# # # #*# # # # #
#          ** **      ****  **#
# # # # # # #*#*# # # #*# # # #
#   ***  6   * ** *** ***    x#
###############################

###############################
#p b*   1                    1#
# #*#s#*#*#*#*#*#*#*#*#*#*#*#*#
#**   * * * *1*   *   * 2 * **#
# # # # # # # # # # # # # # #*#
# *   *   * * * l * * *1  f5**#
# # #*# # # # # # # # #*# # #x#
#f* *** * *   *   * * *   *   #
#*#*#*#*#*#*#*#*#*#*#*#*#*#*#*#
#  *   *   *   *   *   * 2 * *#
# # # # # # # # # # # # # # # #
#*   *   *   * 6 *   *   *   *#
###############################