3 13 31
###############################
#p        *x112     **   b s  #
#*# #b# # # # # #*# # # # # #*#
#       *   *      f  **      #
# # # # #*# # # # # # # # # # #
#     *       *l  *       * * #
# # # # # # #*#*# # # #*#*# # #
#  *  *  *      * s      *** *#
# # # # # #*# # # #*# # # # # #
# *  l *    ***    *     l*** #
# # # #*# #*# # #*# # # # # #*#
#   * *  * *  *             * #
###############################