1 13 31
###############################
#p  35    *   2     **x  b s  #
#*# #b# # # # # #*# # # # # #*#
#   4   *   *      f  **      #
# #1# # #*# # # # # # # # # #2#
#     *       *l  *       * * #
# # # # # # #*#*# # # #*#*# # #
# 1*  *  *      * s      *** *#
# # # # # #*# # # #*# # # # # #
#1*  l *    ***    *     l*** #
# # # #*# #*# # #*# # # # # #*#
#   * *  * * 2*             * #
###############################

###############################
#p1  35 * *  *   *  *         #
# # # # # # # # #*# # # # # # #
# *4 * ****  *s     ***       #
#*# # # # # #2# # # #*# # # # #
#   **       *s *  *   *    * #
#*#*# #*# #*#*# # #*# # # # # #
#     *  l1      2** *   f*   #
# # # # # # # # # # #*#*# # # #
#     *    *b1**  2        ***#
#x# # # # # # # #*# #b# # #*# #
#     *l       *  l    *      #
###############################

###############################
#p31* x*    *  * *      l *f  #
# # # # #l# # #*# # #b# # # # #
#5*  * 4     *           * * *#
# # # # # # # # # #*# #2# # #*#
#  **1    *   **      *       #
# # # # # # # #*# # # # # # #*#
#      *    * ** ** * *  ***  #
# #*#*# # #*# # # # # # # # # #
# * *  **b  *                s#
# # #*#*# # #*# # #s#2# # # # #
#  * l   * 1  *     2      ** #
###############################

###############################
#p3** *  **   * 1    *  *     #
# #*# # # #*#*# # # # # # # #*#
#5 ** 4 * * *    *           *#
# # #*#*#*# # # #*# # # # # # #
# *     ***  1 *      f  * l  #
# # # # # # # #s#*# # # # # # #
#   l            * *       *  #
# #*# #b# # # # # # #*#b# # # #
#    **2*    * *    * 2 *     #
#l# # #1# #*#*# # # # #*# # # #
#  *        *  s***      2  x #
###############################

###############################
#p 3 l  l*2*        ** s      #
# #*# # # #*# #*# #*#*# # # # #
#*5 4     2      **       * **#
# # # # # # # # #*# # # # #*# #
#    f *     *      *  *      #
#*# # # # #x# # # # # #2# # # #
#   *   b   * * 1*  * s    *  #
#*# #*# #1#*# # #*#*# # # # #*#
# *       ** *  *   b         #
# # # # # # #*#*# # # #*# #*# #
#  * **  *   *  *       l *1  #
###############################